111111111111111
110000000000C01
1000111011111E1
100000000000101
100011000000001
110111C00001111
1000000010100C1
1P0101001000001
111111111111111