111111111111111
110000000000C11
100011001111111
100000000000111
1P00110000000E1
111111C00001111
1000000010100C1
100111001000E01
111111111111111